Title: Set of 4 Jute Kilim Pillow Covers | Navajo Southwestern Throw Cushions | Handmade Decor
Price: Â£48.51
Condition: New without tags
Brand: Handmade
Character: Cushion Cover
Closure Type: Zip
Country: India
Department: Girls, Boys, Children, Men, Women
Fill Material: Filler Is Not Included
Item Weight: 400 Grm
MPN: Does Not Apply
Pattern: Squares
Room: Bedroom, Guestroom, Living Room, Any Room
Size: 18 x 18 in
Subject: Abstract Art
Type: Cushion Cover
Care Instructions: Machine Wash
Character Family: Alice in Wonderland
Color: Multicoloured
Customized: No
Features: Decorative
Item Length: 18" Inches
Item Width: 18" Inches
Material: Jute
Product Line: Jute Cushion Cover
Shape: Square
Style: Kilim
Theme: Nature
Color.1: Multicoloured
Unnamed: 37: nan
